1111111111111111111111111111111111111111111111111111111111111111111
1000000000000000000000010000000010000000010000000000000000000000001
10000000000000000000000=00000000100000000=0000000000000000000000001
1000000000000000000000010000000010000000010000000000000000000000001
1000000000000000000000010000000010000000010000000000000000000000001
1111111±11111111111111111111=11110000000010000000000000000000000001
1000000000000000010000010000000010000000010000000000000000000000001
10000000000000000S000001000>>000100000000=0000000000000000000000001
100000000000000001000001000>>00010000000010000000111111111100000001
1000000000000000010000010000000010000000010000000100000000100000001
10000111111=1111111111111111111111111111110000000100000000100000001
100001000000000000000000000000000000000000000000010000B000100000001
1000010000000000000000000000000000000000000000000=00000000100000001
1000010000000000000000000000000000000000000000000100000000100000001
1000010000000000000000000000000000000000000000000100000000100000001
11111111111=1111111111111111=11111111=1111000000010000K000100000001
1000010000000000001000010000000010000000010000000100000000100000001
10000=0000000000001000010000000010000000010000000100000000100000001
1000010000000000001000011111111110000000010000000111111111100000001
100001000000000000=000010000000010000000010000000000000000000000001
10000100000<<0000010000100000000=0000000010000000000000000000000001
10000100000<<000001000010000000010000000010000000000000000000000001
1111111111111111111111111111111111111111111111111111111111111111111

0:floor
1:wall
=:door
±:locked door
S:secret door
<<:stairs up
>>:stairs down
 :null
B:boss
K:key
